11111111111111111111111111111111111
10000C11C0000c000000c0000000000C001
1110C011000C111111111110001100000C1
10000000000000000000000000000000001
111111111110000CCC00111100000000001
1P0000000000000000000111000000C0001
11111111111111111111111100000000001
1E000000000000000000000000000000111
11111111111111111111111111111111111
